#####################
#######   H   #######
#####     B     #####
####   #######   ####
###   #########    ##
##  M###########M  ##
##  #####   #####  ##
# T ####     #### T #
#                   #
# T ####     #### T #
##  #####   #####  ##
##  M###########M  ##
###   #########    ##
####   #######   ####
#####     B     #####
#######   H   #######
#####################
